# # # # # # # # # # # # # # # # # # # # # # # # # # # # # # # # # # # #
# x x x x x x x x x x # # x x T x x x x T x x # # x x x x T x x x x x #
# x x o x x x x o x x x x x x o x x x x o x x x x x o x x x x o x x #
# x x x x x x x x x x x x x x x x x x x x x x x x T x x x x x x T x #
# x x o x x x x o x x # # x x o x x x x o x x # # x x o x x x x o x x #
# x T x x x x T x x x # # x x x x x x x x x x # # x x x x x T x x x x #
# # # # # # # # # x # # # # # # # # # # # # # # # # # # # # # # # # # #
# # # # # # # # # x # # # # # # # # # # # # # # # # # # # # # # # # # #
# x x x x x x x x x x # # x x x x x x x x x x # # x x x x x x x x x x #
# x x o x x x x o x x # # x x o x x x x o x x # # x x o x x x x o x x #
# x x x x x x x x x x # # x x x x x x x x x x # # x x x x x x x x x x #
# x x o x x x x o x x # # x x o x x x x o x x # # x x o x x x x o x x #
# x x x x x x x x x x # # x x x x x x x x x x # # x x x x x x x x x x #
# # # # # # # # # # # # # # # # # # # # # # # # # # # # # # # # # # # #
# # # # # # # # # # # # # # # # # # # # # # # # # # # # # # # # # # # #
# x x x x x x x x x x # # x x x x x x x x x x # # x x x x x x x x x x #
# x x o x x x x o x x # # x x o x x x x o x x # # x x o x x x x o x x #
# x x x x x x x x x x # # x x x x x x x x x x # # x x x x x x x x x x #
# x x o x x x x o x x # # x x o x x x x o x x # # x x o x x x x o x x #
# x x x x x x x x x x # # x x x x x x x x x x # # x x x x x x x x x x #
# # # # # # # # # # # # # # # # # # # # # # # # # # # # # # # # # # # #
# # # # # # # # # # # # # # # # # # # # # # # # # # # # # # # # # # # #
# x x x x x x x x x x # # x x x x x x x x x x # # x x x x x x x x x x #
# x x o x x x x o x x # # x x o x x x x o x x # # x x o x x x x o x x #
# x x x x x x x x x x # # x x x x x x x x x x # # x x x x x x x x x x #
# x x o x x x x o x x # # x x o x x x x o x x # # x x o x x x x o x x #
# x x x x x x x x x x # # x x x x x x x x x x # # x x x x x x x x x x #
# # # # # # # # # # # # # # # # # # # # # # # # # # # # # # # # # # # #
# # # # # # # # # # # # # # # # # # # # # # # # # # # # # # # # # # # #
# x x x x x x x x x x # # x x x x x x x x x x # # x x x x x x x x x x #
# x x o x x x x o x x # # x x o x x x x o x x # # x x o x x x x o x x #
# x x x x x x x x x x # # x x x x x x x x x x # # x x x x x x x x x x #
# x x o x x x x o x x # # x x o x x x x o x x # # x x o x x x x o x x #
# x x x x x x x x x x # # x x x x x x x x x x # # x x x x x x x x x x #
# # # # # # # # # # # # # # # # # # # # # # # # # # # # # # # # # # # #
# # # # # # # # # # # # # # # # # # # # # # # # # # # # # # # # # # # #
# x x x x x x x x x x # # x x x x x x x x x x # # x x x x x x x x x x #
# x x o x x x x o x x # # x x o x x x x o x x # # x x o x x x x o x x #
# x x x x x x x x x x # # x x x x x x x x x x # # x x x x x x x x x x #
# x x o x x x x o x x # # x x o x x x x o x x # # x x o x x x x o x x #
# x x x x x x x x x x # # x x x x x x x x x x # # x x x x x x x x x x #
# # # # # # # # # # # # # # # # # # # # # # # # # # # # # # # # # # # #
# # # # # # # # # # # # # # # # # # # # # # # # # # # # # # # # # # # #
# x x x x x x x x x x # # x x x x x x x x x x # # x x x x x x x x x x #
# x x o x x x x o x x # # x x o x x x x o x x # # x x o x x x x o x x #
# x x x x x x x x x x # # x x x x x x x x x x # # x x x x x x x x x x #
# x x o x x x x o x x # # x x o x x x x o x x # # x x o x x x x o x x #
# x x x x x x x x x x # # x x x x x x x x x x # # x x x x x x x x x x #
# # # # # # # # # # # # # # # # # # # # # # # # # # # # # # # # # # # #
# # # # # # # # # # # # # # # # # # # # # # # # # # # # # # # # # # # #
# x x x x x x x x x x # # x x x x x x x x x x # # x x x x x x x x x x #
# x x o x x x x o x x # # x x o x x x x o x x # # x x o x x x x o x x #
# x x x x x x x x x x # # x x x x x x x x x x # # x x x x x x x x x x #
# x x o x x x x o x x # # x x o x x x x o x x # # x x o x x x x o x x #
# x x x x x x x x x x # # x x x x x x x x x x # # x x x x x x x x x x #
# # # # # # # # # # # # # # # # # # # # # # # # # # # # # # # # # # # #
# # # # # # # # # # # # # # # # # # # # # # # # # # # # # # # # # # # #
# x x x x x x x x x x # # x x x x x x x x x x # # x x x x x x x x x x #
# x x o x x x x o x x # # x x o x x x x o x x # # x x o x x x x o x x #
# x x x x x x x x x x # # x x x x x x x x x x # # x x x x x x x x x x #
# x x o x x x x o x x # # x x o x x x x o x x # # x x o x x x x o x x #
# x x x x x x x x x x # # x x x x x x x x x x # # x x x x x x x x x x #
# # # # # # # # # # # # # # # # # # # # # # # # # # # # # # # # # # # #
# # # # # # # # # # # # # # # # # # # # # # # # # # # # # # # # # # # #
# x x x x x x x x x x # # x x x x x x x x x x # # x x x x x x x x x x #
# x x o x x x x o x x # # x x o x x x x o x x # # x x o x x x x o x x #
# x x x x x x x x x x # # x x x x x x x x x x # # x x x x x x x x x x #
# x x o x x x x o x x # # x x o x x x x o x x # # x x o x x x x o x x #
# x x x x x x x x x x # # x x x x x x x x x x # # x x x x x x x x x x #
# # # # # # # # # # # # # # # # # # # # # # # # # # # # # # # # # # # #
