# # # # # # # # # # # # # # # # # # # # # # # # # # # # # # # # # # # #
# x x x x x x x x T x # # x x x x x T > x x x # # x x x x x x x x x x #
# x x o x x x x o V x x x x ^ o x x x x o x x x x x x o ^ T > x o x x #
# x x x x x x x x x x x x x T x x x x x x T x x x x x x T x x T x x x #
# x ^ o x x x x o x x # # x x o x x x x o V x # # x x o x < T V o x x #
# x T x x x x x x x x # # x x x x x < T x x x # # x x x x x x x x x x #
# # # # # # # # # x # # # # # # # # # # # # # # # # # # # # # # # # # #
# # # # # # # # # x # # # # # # # # # # # # # # # # # # # # # # # # # #
# x x x x x x x x x x # # x x x x x x x x x x # # x x x x x x x x x x #
# x x o x x x x o x x # # x x o x x x x o x x # # x x o x x x x o x x #
# x x x x x x x x x x # # x x x x x x x x x x # # x x x x x x x x x x #
# x x o x x x x o x x # # x x o x x x x o x x # # x x o x x x x o x x #
# x x x x x x x x x x # # x x x x x x x x x x # # x x x x x x x x x x #
# # # # # # # # # # # # # # # # # # # # # # # # # # # # # # # # # # # #
# # # # # # # # # # # # # # # # # # # # # # # # # # # # # # # # # # # #
# x x x x x x x x x x # # x x x x x x x x x x # # x x x x x x x x x x #
# x x o x x x x o x x # # x x o x x x x o x x # # x x o x x x x o x x #
# x x x x x x x x x x # # x x x x x x x x x x # # x x x x x x x x x x #
# x x o x x x x o x x # # x x o x x x x o x x # # x x o x x x x o x x #
# x x x x x x x x x x # # x x x x x x x x x x # # x x x x x x x x x x #
# # # # # # # # # # # # # # # # # # # # # # # # # # # # # # # # # # # #
# # # # # # # # # # # # # # # # # # # # # # # # # # # # # # # # # # # #
# x x x x x x x x x x # # x x x x x x x x x x # # x x x x x x x x x x #
# x x o x x x x o x x # # x x o x x x x o x x # # x x o x x x x o x x #
# x x x x x x x x x x # # x x x x x x x x x x # # x x x x x x x x x x #
# x x o x x x x o x x # # x x o x x x x o x x # # x x o x x x x o x x #
# x x x x x x x x x x # # x x x x x x x x x x # # x x x x x x x x x x #
# # # # # # # # # # # # # # # # # # # # # # # # # # # # # # # # # # # #
# # # # # # # # # # # # # # # # # # # # # # # # # # # # # # # # # # # #
# x x x x x x x x x x # # x x x x x x x x x x # # x x x x x x x x x x #
# x x o x x x x o x x # # x x o x x x x o x x # # x x o x x x x o x x #
# x x x x x x x x x x # # x x x x x x x x x x # # x x x x x x x x x x #
# x x o x x x x o x x # # x x o x x x x o x x # # x x o x x x x o x x #
# x x x x x x x x x x # # x x x x x x x x x x # # x x x x x x x x x x #
# # # # # # # # # # # # # # # # # # # # # # # # # # # # # # # # # # # #
# # # # # # # # # # # # # # # # # # # # # # # # # # # # # # # # # # # #
# x x x x x x x x x x # # x x x x x x x x x x # # x x x x x x x x x x #
# x x o x x x x o x x # # x x o x x x x o x x # # x x o x x x x o x x #
# x x x x x x x x x x # # x x x x x x x x x x # # x x x x x x x x x x #
# x x o x x x x o x x # # x x o x x x x o x x # # x x o x x x x o x x #
# x x x x x x x x x x # # x x x x x x x x x x # # x x x x x x x x x x #
# # # # # # # # # # # # # # # # # # # # # # # # # # # # # # # # # # # #
# # # # # # # # # # # # # # # # # # # # # # # # # # # # # # # # # # # #
# x x x x x x x x x x # # x x x x x x x x x x # # x x x x x x x x x x #
# x x o x x x x o x x # # x x o x x x x o x x # # x x o x x x x o x x #
# x x x x x x x x x x # # x x x x x x x x x x # # x x x x x x x x x x #
# x x o x x x x o x x # # x x o x x x x o x x # # x x o x x x x o x x #
# x x x x x x x x x x # # x x x x x x x x x x # # x x x x x x x x x x #
# # # # # # # # # # # # # # # # # # # # # # # # # # # # # # # # # # # #
# # # # # # # # # # # # # # # # # # # # # # # # # # # # # # # # # # # #
# x x x x x x x x x x # # x x x x x x x x x x # # x x x x x x x x x x #
# x x o x x x x o x x # # x x o x x x x o x x # # x x o x x x x o x x #
# x x x x x x x x x x # # x x x x x x x x x x # # x x x x x x x x x x #
# x x o x x x x o x x # # x x o x x x x o x x # # x x o x x x x o x x #
# x x x x x x x x x x # # x x x x x x x x x x # # x x x x x x x x x x #
# # # # # # # # # # # # # # # # # # # # # # # # # # # # # # # # # # # #
# # # # # # # # # # # # # # # # # # # # # # # # # # # # # # # # # # # #
# x x x x x x x x x x # # x x x x x x x x x x # # x x x x x x x x x x #
# x x o x x x x o x x # # x x o x x x x o x x # # x x o x x x x o x x #
# x x x x x x x x x x # # x x x x x x x x x x # # x x x x x x x x x x #
# x x o x x x x o x x # # x x o x x x x o x x # # x x o x x x x o x x #
# x x x x x x x x x x # # x x x x x x x x x x # # x x x x x x x x x x #
# # # # # # # # # # # # # # # # # # # # # # # # # # # # # # # # # # # #
# # # # # # # # # # # # # # # # # # # # # # # # # # # # # # # # # # # #
# x x x x x x x x x x # # x x x x x x x x x x # # x x x x x x x x x x #
# x x o x x x x o x x # # x x o x x x x o x x # # x x o x x x x o x x #
# x x x x x x x x x x # # x x x x x x x x x x # # x x x x x x x x x x #
# x x o x x x x o x x # # x x o x x x x o x x # # x x o x x x x o x x #
# x x x x x x x x x x # # x x x x x x x x x x # # x x x x x x x x x x #
# # # # # # # # # # # # # # # # # # # # # # # # # # # # # # # # # # # #
